##################################################
#                                                #
#                                                #
#        $                                       #
#                                                #
#                                                #
#                                                #
#             ***                                #
#                                *               #
####### ######                                   #
#           ########                             #
#            #                                   #
#            # && &&                             #
#        ##  #                                   #
#            #                                   #
#        #####                                   #
#        #                     $                 #
#     ####                                       #
#        #                                       #
##################################################