##########################################################################################################################################################################
#                                                                                                                                                                        #
#           ######## ##                                                                                                                                                  #
#           #         #                                                                                                                                                  #
#           #         #                                                                                                                                                  #
#           ##        #                                                                                                                                                  #
#            ##       #                                                                                                                                                  #
#             ##     #                         $$                                                                                                                        #
#              #     #                                                       *********                                                                                   #
#       ****   #    ##                                                                                   #                           $                                   #
#              ######                                                                                                                                                    #
#                                                                                                       #                                                                #
#                                                                                                       #                                                                #
#                                                                                                       #    ###########                                                 #
#                                       $                                                               ################                                                 #
#                                                                                                $                                                                       #
#                                                                                                                                                                        #
#                                                                                  $                                                                                     #
#                                                                                                                   *                                                    #
#                                  $$                                                                                                                                    #
#                                $$$$                             #                                                                                                      #
#                                                             ## # # ##                                                                                                  #
#                                                               **#*                                                                                                     #
#####################################  ##########                                                                 #                                                      #
#                              #           #    #                    #                                                                                                   #
#                              #           #    #                 ######                    $                                                     $$                     #
#                              #           #    ###                 #    #                                                                                               #
#                              ######  #####      #                       $#     #                                                                                       #
#                                                 #             #                                                                                                        #
#                                                 #            $#     ##                                         ####                                                    #
#                                                 #            #       #                                           #                                                     #
#                                                 #            #       #                                           #                                                     #
#                                                 #            ##      #                                           ##                                                    #
#                                 ##  ##############            #       #                    ######               ##                                                     #
#                                 #  $             #            #       #                         ##             ##                                                      #
#                                 #  $             #            #       #                          #             ##                                                      #
#                                 #                #            ##  ######                         #            ##                                                       #
########################          #                #                                             ######       ##                                                         #
#                      #          #                #                                             ####        ##                                                          #
# $$$$$                           #                #                                             ####        ##                                                          #
#  $$$$                           #                #                                                #### ########                                                        #
#                      #          #                #                                                ####                                                                 #
##########################################################################################################################################################################